11111111111111111111
1P0000000000000000C1
101000000CC111111101
101111111CC000000101
1C0000000000000000E1
11111111111111111111