1111111111111111
1C000000000000C1
1011111111111101
101C00000000C101
1010111001110101
1010100000010101
1010101111010101
1010101EP1010101
1010101001010101
1010101001010101
1010100000010101
1010111111110101
101C00000000C101
1011111001111101
1C000000000000C1
1111111111111111