1111111111
100000C001
1000000001
1000000001
1000PPP001
10000E0001
1000000001
1000000001
10C0000001
1111111111