1111111111
10C0000001
1000000001
100000C001
1000000001
10000E0001
100C000001
1000000001
1000000001
1111111111