11111111111111111111
1P0000000000000000C1
101000000CC1111111011
101111111CC0000001001
1C0000000000000000E11
11111111111111111111