1111111111
100001C001
1000010001
1000011111
1000000001
10000E0001
1000000001
1000000001
10C00000P1
1111111111