1111111111
10000C0001
1000000001
1000000001
1000P00001
10000C0001
10C0000001
1000000001
10000000C1
1111111111