1111111111
1P0000C001
1000000001
1000000001
1000111111
10001E0001
1000100001
1000111111
10C0000001
1111111111